#######################################################
#                                                     #
# ####  ######  #######  ######  ######  #####  ####  #
# #                                                #  #
#    ####   ######   #############   #####   ####     #
# #  #                                          #  #  #
# #  # ######################################## #  #  #
# #                                                #  #
#    #   ##################################     #     #
# #  #   #                                #     #  #  #
# #  #   #  ############################  #     #  #  #
# #  #                                          #  #  #
#    #   #  ############################  #     #     #
# #  #   #                                #     #  #  #
#    #   ##################################     #     #
# #                                                #  #
# #  # ######################################## #  #  #
# #  #                                          #  #  #
#    ####   ######   #############   #####   ####     #
# #                                                #  #
# ####  ######  #######  ######  ######  #####  ####  #
#                                                     #
#######################################################