#######################################################
#      ####                   #         #         #   #
#         #  ###       #      ##        #            ##
#  #      #            ##     #         #       #     #
#  #      ###  ###     ###        ###   ####   ###    #
#  #          ##       #          #             #     #
#  ####                      #  ###                   #
#     #      #####     #                  ####        #
#     #      ##        #     ##  ##       #     #     #
#            ##                           #           #
##   ####  ####               ########    #  ####  ####
#  ###  #     #       #####          #       #        #
#  #    #     #       #####    ###  ##       #        #
#  #    ##  #         ###            #   ###    #     #
#  #     #  #     #       ##         #   #      ##### #
#  #     #  #     #       ##             #            #
#  ###   ####     ######       #   ##    #       ##   #
#             #        #       #  ###         #   #   #
#  ###        #        ####    #    #         #   #   #
#    #        #    #   ####    #    ######    #####   #
#    #   ######    #           #         #    #       #
#                  #           #              #       #
#######################################################