#######################################################
#                                                     #
#         ###          ##############   #  #####      #
###  #                 ##           #   #  #   #      #
#         ##   ###     ###        ###   ####   #      #
#         #  ########  #          #            #####  #
#  ####   #         #  #   ########  #######          #
#     #   #  #####  #  #   #         #    #           #
#     #      ##     ####   # ######  #    #     ##    #
#            ##            #  #      #    #     ##    #
######    #####            #  #      #    #  ##     ###
#  #          #       ##   #  #      #                #
#  #          #            #  ##    ##                #
#  #  #       #####   ######  #      #      #    #    #
#  #     #        #   #       #      #          #  ## #
#        #        #           ####             #      #
#  # #   #        ######         ##    #####  #       #
#             #        #  ######       #   # #    #   #
############           ####    #   #   #   ###   ##   #
#                  #           #   #   #        ##    #
##       #   ##    #      #        #   #      ###     #
#  #                #      #       #   #       #      #
#######################################################